0 0 0 0 0 1 1 0 0 5
0 1 0 1 0 1 1 0 1 0
0 1 0 0 4 4 4 0 1 0
2 1 0 1 1 1 0 1 1 0
0 1 3 4 4 0 0 1 1 0
0 1 0 1 1 1 0 1 1 0
0 1 0 0 1 1 0 0 0 0
0 1 1 0 0 1 0 1 1 0
0 1 1 1 0 0 0 1 0 0
0 1 1 1 1 1 1 1 0 1